Date,Category,RefNo,Withdrawal,Deposit,Balance,Day,Month,Weekday
2023-01-13 00:00:00,Food,3.38E+11,57.0,0.0,571.73,13,1,4
2023-01-13 00:00:00,Food,3.01E+11,60.0,0.0,511.73,13,1,4
2023-01-13 00:00:00,Misc,3.38E+11,480.0,0.0,31.73,13,1,4
2023-01-13 00:00:00,Food,3.38E+11,12.0,0.0,19.73,13,1,4
2023-01-13 00:00:00,Misc,3.38E+11,0.0,2000.0,2019.73,13,1,4
2023-01-13 00:00:00,Misc,3.38E+11,0.0,120.0,2139.73,13,1,4
2023-01-13 00:00:00,Food,3.01E+11,50.0,0.0,2089.73,13,1,4
2023-01-13 00:00:00,Misc,3.01E+11,0.0,200.0,2289.73,13,1,4
2023-01-13 00:00:00,Food,3.38E+11,15.0,0.0,2274.73,13,1,4
2023-01-14 00:00:00,Food,3.01E+11,40.0,0.0,2234.73,14,1,5
2023-01-14 00:00:00,Food,3.38E+11,30.0,0.0,2204.73,14,1,5
2023-01-14 00:00:00,Food,3.01E+11,173.75,0.0,2030.98,14,1,5
2023-01-14 00:00:00,Misc,3.38E+11,0.0,25.0,2055.98,14,1,5
2023-01-14 00:00:00,Food,3.38E+11,50.0,0.0,2005.98,14,1,5
2023-01-14 00:00:00,Food,3.38E+11,20.0,0.0,1985.98,14,1,5
2023-01-14 00:00:00,Misc,3.38E+11,0.0,10.0,1995.98,14,1,5
2023-01-14 00:00:00,Food,3.38E+11,30.0,0.0,1965.98,14,1,5
2023-01-15 00:00:00,Misc,3.38E+11,110.0,0.0,1855.98,15,1,6
2023-01-15 00:00:00,Food,3.02E+11,35.0,0.0,1820.98,15,1,6
2023-01-15 00:00:00,Misc,3.38E+11,200.0,0.0,1620.98,15,1,6
2023-01-15 00:00:00,Food,3.38E+11,30.0,0.0,1590.98,15,1,6
2023-01-15 00:00:00,Food,3.38E+11,40.0,0.0,1550.98,15,1,6
2023-01-15 00:00:00,Food,3.38E+11,155.24,0.0,1395.74,15,1,6
2023-01-15 00:00:00,Food,3.38E+11,25.0,0.0,1370.74,15,1,6
2023-01-16 00:00:00,Food,3.02E+11,12.0,0.0,1358.74,16,1,0
2023-01-16 00:00:00,Food,3.02E+11,33.0,0.0,1325.74,16,1,0
2023-01-16 00:00:00,Food,3.38E+11,29.0,0.0,1296.74,16,1,0
2023-01-16 00:00:00,Food,3.38E+11,50.0,0.0,1246.74,16,1,0
2023-01-16 00:00:00,Food,3.38E+11,60.0,0.0,1186.74,16,1,0
2023-01-16 00:00:00,Food,3.38E+11,32.0,0.0,1154.74,16,1,0
2023-01-16 00:00:00,Food,3.38E+11,20.0,0.0,1134.74,16,1,0
2023-01-17 00:00:00,Food,3.02E+11,37.0,0.0,1097.74,17,1,1
2023-01-17 00:00:00,Misc,3.02E+11,272.0,0.0,825.74,17,1,1
2023-01-17 00:00:00,Food,3.38E+11,70.0,0.0,755.74,17,1,1
2023-01-17 00:00:00,Food,3.38E+11,30.0,0.0,725.74,17,1,1
2023-01-17 00:00:00,Food,3.02E+11,85.0,0.0,640.74,17,1,1
2023-01-17 00:00:00,Food,3.38E+11,20.0,0.0,620.74,17,1,1
2023-01-17 00:00:00,Food,3.38E+11,20.0,0.0,600.74,17,1,1
2023-01-18 00:00:00,Food,3.38E+11,10.0,0.0,590.74,18,1,2
2023-01-18 00:00:00,Food,3.02E+11,33.0,0.0,557.74,18,1,2
2023-01-18 00:00:00,Food,3.38E+11,20.0,0.0,537.74,18,1,2
2023-01-18 00:00:00,Food,3.38E+11,60.0,0.0,477.74,18,1,2
2023-01-18 00:00:00,Food,3.38E+11,40.0,0.0,437.74,18,1,2
2023-01-18 00:00:00,Food,3.38E+11,40.0,0.0,397.74,18,1,2
2023-01-19 00:00:00,Misc,3.02E+11,0.0,120.0,517.74,19,1,3
2023-01-19 00:00:00,Misc,3.39E+11,130.0,0.0,387.74,19,1,3
2023-01-19 00:00:00,Food,3.39E+11,30.0,0.0,357.74,19,1,3
2023-01-19 00:00:00,Food,3.39E+11,12.0,0.0,345.74,19,1,3
2023-01-19 00:00:00,Food,3.02E+11,25.0,0.0,320.74,19,1,3
2023-01-19 00:00:00,Food,3.02E+11,55.0,0.0,265.74,19,1,3
2023-01-20 00:00:00,Food,3.39E+11,10.0,0.0,255.74,20,1,4
2023-01-20 00:00:00,Food,3.39E+11,42.0,0.0,213.74,20,1,4
2023-01-20 00:00:00,Food,3.39E+11,30.0,0.0,183.74,20,1,4
2023-01-20 00:00:00,Food,3.02E+11,20.0,0.0,163.74,20,1,4
2023-01-20 00:00:00,Food,3.39E+11,40.0,0.0,123.74,20,1,4
2023-01-20 00:00:00,Misc,3.39E+11,0.0,500.0,623.74,20,1,4
2023-01-21 00:00:00,Food,3.02E+11,42.0,0.0,581.74,21,1,5
2023-01-21 00:00:00,Food,3.02E+11,80.0,0.0,501.74,21,1,5
2023-01-21 00:00:00,Food,3.02E+11,30.0,0.0,471.74,21,1,5
2023-01-21 00:00:00,Food,3.39E+11,25.0,0.0,446.74,21,1,5
2023-01-21 00:00:00,Misc,3.39E+11,200.0,0.0,246.74,21,1,5
2023-01-21 00:00:00,Food,3.02E+11,30.0,0.0,216.74,21,1,5
2023-01-21 00:00:00,Misc,3.39E+11,200.0,0.0,16.74,21,1,5
2023-01-22 00:00:00,Misc,3.02E+11,0.0,2000.0,2016.74,22,1,6
2023-01-22 00:00:00,Food,3.39E+11,61.0,0.0,1955.74,22,1,6
2023-01-22 00:00:00,Misc,3.39E+11,115.0,0.0,1840.74,22,1,6
2023-01-22 00:00:00,Food,3.39E+11,30.0,0.0,1810.74,22,1,6
2023-01-23 00:00:00,Food,3.02E+11,15.0,0.0,1795.74,23,1,0
2023-01-23 00:00:00,Food,3.02E+11,33.0,0.0,1762.74,23,1,0
2023-01-23 00:00:00,Food,3.39E+11,65.0,0.0,1697.74,23,1,0
2023-01-23 00:00:00,Food,3.39E+11,30.0,0.0,1667.74,23,1,0
2023-01-23 00:00:00,Food,3.02E+11,70.0,0.0,1597.74,23,1,0
2023-01-23 00:00:00,Misc,3.39E+11,0.0,35.0,1632.74,23,1,0
2023-01-23 00:00:00,Food,3.39E+11,30.0,0.0,1602.74,23,1,0
2023-01-24 00:00:00,Food,3.39E+11,20.0,0.0,1582.74,24,1,1
2023-01-24 00:00:00,Food,3.39E+11,90.0,0.0,1492.74,24,1,1
2023-01-24 00:00:00,Food,3.02E+11,75.0,0.0,1417.74,24,1,1
2023-01-24 00:00:00,Food,3.02E+11,20.0,0.0,1397.74,24,1,1
2023-01-24 00:00:00,Food,3.39E+11,50.0,0.0,1347.74,24,1,1
2023-01-25 00:00:00,Food,3.03E+11,28.0,0.0,1319.74,25,1,2
2023-01-25 00:00:00,Other,CHASR23023738798,0.0,34800.0,36119.74,25,1,2
2023-01-25 00:00:00,Food,3.39E+11,65.0,0.0,36054.74,25,1,2
2023-01-25 00:00:00,Food,3.03E+11,27.0,0.0,36027.74,25,1,2
2023-01-25 00:00:00,Food,3.03E+11,30.0,0.0,35997.74,25,1,2
2023-01-25 00:00:00,Misc,3.39E+11,10000.0,0.0,25997.74,25,1,2
2023-01-25 00:00:00,Misc,3.39E+11,350.0,0.0,25647.74,25,1,2
2023-01-25 00:00:00,Food,3.39E+11,40.0,0.0,25607.74,25,1,2
2023-01-25 00:00:00,Misc,3.39E+11,2.0,0.0,25605.74,25,1,2
2023-01-25 00:00:00,Misc,3.39E+11,135.0,0.0,25470.74,25,1,2
2023-01-26 00:00:00,Food,3.03E+11,20.0,0.0,25450.74,26,1,3
2023-01-26 00:00:00,Misc,3.03E+11,120.0,0.0,25330.74,26,1,3
2023-01-26 00:00:00,Other,3.03E+11,1081.0,0.0,24249.74,26,1,3
2023-01-26 00:00:00,Misc,3.03E+11,5000.0,0.0,19249.74,26,1,3
2023-01-26 00:00:00,Misc,3.39E+11,299.0,0.0,18950.74,26,1,3
2023-01-26 00:00:00,Misc,3.39E+11,2000.0,0.0,16950.74,26,1,3
2023-01-26 00:00:00,Misc,3.03E+11,1000.0,0.0,15950.74,26,1,3
2023-01-26 00:00:00,Misc,3.39E+11,0.0,5000.0,20950.74,26,1,3
2023-01-26 00:00:00,Misc,3.39E+11,5000.0,0.0,15950.74,26,1,3
2023-01-26 00:00:00,Food,3.39E+11,163.28,0.0,15787.46,26,1,3
2023-01-27 00:00:00,Food,3.03E+11,24.0,0.0,15763.46,27,1,4
2023-01-27 00:00:00,Misc,3.39E+11,288.0,0.0,15475.46,27,1,4
2023-01-27 00:00:00,Food,3.39E+11,70.0,0.0,15405.46,27,1,4
2023-01-27 00:00:00,Misc,3.39E+11,0.0,72.0,15477.46,27,1,4
2023-01-27 00:00:00,Misc,3.03E+11,0.0,7000.0,22477.46,27,1,4
2023-01-27 00:00:00,Misc,3.03E+11,17500.0,0.0,4977.46,27,1,4
2023-01-27 00:00:00,Food,3.39E+11,40.0,0.0,4937.46,27,1,4
2023-01-27 00:00:00,Food,3.39E+11,80.0,0.0,4857.46,27,1,4
2023-01-28 00:00:00,Food,3.39E+11,40.0,0.0,4817.46,28,1,5
2023-01-28 00:00:00,Food,3.03E+11,40.0,0.0,4777.46,28,1,5
2023-01-28 00:00:00,Misc,3.03E+11,1000.0,0.0,3777.46,28,1,5
2023-01-28 00:00:00,Food,3.39E+11,40.0,0.0,3737.46,28,1,5
2023-01-29 00:00:00,Food,3.40E+11,20.0,0.0,3717.46,29,1,6
2023-01-29 00:00:00,Food,3.03E+11,40.0,0.0,3677.46,29,1,6
2023-01-29 00:00:00,Misc,3.40E+11,149.0,0.0,3528.46,29,1,6
2023-01-29 00:00:00,Misc,3.03E+11,250.0,0.0,3278.46,29,1,6
2023-01-29 00:00:00,Misc,3.40E+11,250.0,0.0,3028.46,29,1,6
2023-01-29 00:00:00,Misc,3.40E+11,500.0,0.0,2528.46,29,1,6
2023-01-29 00:00:00,Food,3.40E+11,189.05,0.0,2339.41,29,1,6
2023-01-29 00:00:00,Food,3.40E+11,40.0,0.0,2299.41,29,1,6
2023-01-30 00:00:00,Food,3.03E+11,50.0,0.0,2249.41,30,1,0
2023-01-30 00:00:00,Food,3.40E+11,85.0,0.0,2164.41,30,1,0
2023-01-30 00:00:00,Food,3.40E+11,50.0,0.0,2114.41,30,1,0
2023-01-30 00:00:00,Food,3.40E+11,90.0,0.0,2024.41,30,1,0
2023-01-30 00:00:00,Food,3.40E+11,20.0,0.0,2004.41,30,1,0
2023-01-31 00:00:00,Food,3.03E+11,28.0,0.0,1976.41,31,1,1
2023-01-31 00:00:00,Misc,3.40E+11,125.0,0.0,1851.41,31,1,1
2023-01-31 00:00:00,Food,3.03E+11,40.0,0.0,1811.41,31,1,1
2023-01-31 00:00:00,Misc,3.03E+11,0.0,10000.0,11811.41,31,1,1
2023-01-31 00:00:00,Food,3.40E+11,154.44,0.0,11656.97,31,1,1
2023-02-13 00:00:00,Food,3.04E+11,40.0,0.0,1071.54,13,2,0
2023-02-13 00:00:00,Food,3.41E+11,173.7,0.0,897.84,13,2,0
2023-02-13 00:00:00,Food,3.04E+11,67.0,0.0,830.84,13,2,0
2023-02-13 00:00:00,Food,3.41E+11,40.0,0.0,790.84,13,2,0
2023-02-14 00:00:00,Food,3.41E+11,40.0,0.0,750.84,14,2,1
2023-02-14 00:00:00,Food,3.05E+11,242.45,0.0,508.39,14,2,1
2023-02-14 00:00:00,Food,3.05E+11,60.0,0.0,448.39,14,2,1
2023-02-15 00:00:00,Food,3.05E+11,40.0,0.0,408.39,15,2,2
2023-02-15 00:00:00,Food,3.05E+11,148.0,0.0,260.39,15,2,2
2023-02-15 00:00:00,Misc,3.05E+11,130.0,0.0,130.39,15,2,2
2023-02-16 00:00:00,Food,3.05E+11,30.0,0.0,100.39,16,2,3
2023-02-16 00:00:00,Food,3.41E+11,40.0,0.0,60.39,16,2,3
2023-02-16 00:00:00,Misc,3.05E+11,0.0,80.0,140.39,16,2,3
2023-02-16 00:00:00,Food,3.05E+11,100.0,0.0,40.39,16,2,3
2023-02-16 00:00:00,Misc,3.41E+11,0.0,1500.0,1540.39,16,2,3
2023-02-17 00:00:00,Misc,3.05E+11,5.0,0.0,1535.39,17,2,4
2023-02-17 00:00:00,Food,3.41E+11,20.0,0.0,1515.39,17,2,4
2023-02-17 00:00:00,Food,3.05E+11,30.0,0.0,1485.39,17,2,4
2023-02-17 00:00:00,Food,3.41E+11,65.0,0.0,1420.39,17,2,4
2023-02-17 00:00:00,Food,3.41E+11,30.0,0.0,1390.39,17,2,4
2023-02-17 00:00:00,Food,3.41E+11,70.0,0.0,1320.39,17,2,4
2023-02-17 00:00:00,Food,3.05E+11,50.0,0.0,1270.39,17,2,4
2023-02-17 00:00:00,Misc,3.05E+11,475.0,0.0,795.39,17,2,4
2023-02-17 00:00:00,Food,3.41E+11,30.0,0.0,765.39,17,2,4
2023-02-18 00:00:00,Food,3.42E+11,10.0,0.0,755.39,18,2,5
2023-02-18 00:00:00,Food,3.05E+11,60.0,0.0,695.39,18,2,5
2023-02-18 00:00:00,Food,3.42E+11,20.0,0.0,675.39,18,2,5
2023-02-18 00:00:00,Food,3.42E+11,70.0,0.0,605.39,18,2,5
2023-02-18 00:00:00,Food,3.42E+11,20.0,0.0,585.39,18,2,5
2023-02-19 00:00:00,Misc,3.05E+11,150.5,0.0,434.89,19,2,6
2023-02-19 00:00:00,Misc,3.05E+11,136.0,0.0,298.89,19,2,6
2023-02-19 00:00:00,Misc,3.42E+11,8.0,0.0,290.89,19,2,6
2023-02-19 00:00:00,Food,3.05E+11,67.0,0.0,223.89,19,2,6
2023-02-19 00:00:00,Food,3.05E+11,100.0,0.0,123.89,19,2,6
2023-02-19 00:00:00,Food,3.42E+11,40.0,0.0,83.89,19,2,6
2023-02-20 00:00:00,Food,3.42E+11,40.0,0.0,43.89,20,2,0
2023-02-20 00:00:00,Misc,3.42E+11,0.0,500.0,543.89,20,2,0
2023-02-20 00:00:00,Food,3.05E+11,65.0,0.0,478.89,20,2,0
2023-02-20 00:00:00,Food,3.42E+11,20.0,0.0,458.89,20,2,0
2023-02-20 00:00:00,Food,3.05E+11,45.0,0.0,413.89,20,2,0
2023-02-21 00:00:00,Food,3.42E+11,33.0,0.0,380.89,21,2,1
2023-02-21 00:00:00,Food,3.05E+11,40.0,0.0,340.89,21,2,1
2023-02-21 00:00:00,Food,3.42E+11,30.0,0.0,310.89,21,2,1
2023-02-21 00:00:00,Food,3.05E+11,50.0,0.0,260.89,21,2,1
2023-02-21 00:00:00,Food,3.05E+11,35.0,0.0,225.89,21,2,1
2023-02-22 00:00:00,Misc,3.42E+11,0.0,6000.0,6225.89,22,2,2
2023-02-22 00:00:00,Misc,3.05E+11,5500.0,0.0,725.89,22,2,2
2023-02-22 00:00:00,Food,3.42E+11,50.0,0.0,675.89,22,2,2
2023-02-22 00:00:00,Food,3.42E+11,35.0,0.0,640.89,22,2,2
2023-02-22 00:00:00,Food,3.05E+11,50.0,0.0,590.89,22,2,2
2023-02-22 00:00:00,Food,3.05E+11,42.0,0.0,548.89,22,2,2
2023-02-23 00:00:00,Food,3.42E+11,20.0,0.0,528.89,23,2,3
2023-02-23 00:00:00,Food,3.05E+11,40.0,0.0,488.89,23,2,3
2023-02-23 00:00:00,Misc,3.42E+11,400.0,0.0,88.89,23,2,3
2023-02-23 00:00:00,Food,3.05E+11,30.0,0.0,58.89,23,2,3
2023-02-23 00:00:00,Food,3.05E+11,40.0,0.0,18.89,23,2,3
2023-02-24 00:00:00,Other,CHASS23053481613,0.0,34800.0,34818.89,24,2,4
2023-02-24 00:00:00,Food,3.06E+11,70.0,0.0,34748.89,24,2,4
2023-02-24 00:00:00,Food,3.06E+11,40.0,0.0,34708.89,24,2,4
2023-02-24 00:00:00,Misc,3.06E+11,799.0,0.0,33909.89,24,2,4
2023-02-24 00:00:00,Misc,3.42E+11,180.0,0.0,33729.89,24,2,4
2023-02-24 00:00:00,Food,3.42E+11,75.0,0.0,33654.89,24,2,4
2023-02-24 00:00:00,Misc,3.06E+11,642.0,0.0,33012.89,24,2,4
2023-02-24 00:00:00,Food,3.42E+11,12.0,0.0,33000.89,24,2,4
2023-02-25 00:00:00,Misc,3.42E+11,10000.0,0.0,23000.89,25,2,5
2023-02-25 00:00:00,Misc,3.06E+11,140.0,0.0,22860.89,25,2,5
2023-02-25 00:00:00,Food,3.42E+11,20.0,0.0,22840.89,25,2,5
2023-02-25 00:00:00,Food,3.42E+11,10.0,0.0,22830.89,25,2,5
2023-02-25 00:00:00,Food,3.42E+11,40.0,0.0,22790.89,25,2,5
2023-02-25 00:00:00,Misc,3.42E+11,500.0,0.0,22290.89,25,2,5
2023-02-25 00:00:00,Food,3.42E+11,25.0,0.0,22265.89,25,2,5
2023-02-25 00:00:00,Misc,3.42E+11,0.0,2000.0,24265.89,25,2,5
2023-02-25 00:00:00,Misc,3.42E+11,4003.0,0.0,20262.89,25,2,5
2023-02-26 00:00:00,Food,3.06E+11,34.0,0.0,20228.89,26,2,6
2023-02-26 00:00:00,Food,3.06E+11,22.0,0.0,20206.89,26,2,6
2023-02-26 00:00:00,Food,3.06E+11,10.0,0.0,20196.89,26,2,6
2023-02-26 00:00:00,Misc,3.06E+11,0.0,3400.0,23596.89,26,2,6
2023-02-26 00:00:00,Food,3.42E+11,20.0,0.0,23576.89,26,2,6
2023-02-26 00:00:00,Misc,3.06E+11,4000.0,0.0,19576.89,26,2,6
2023-02-26 00:00:00,Other,3.06E+11,251.0,0.0,19325.89,26,2,6
2023-02-26 00:00:00,Misc,3.42E+11,1000.0,0.0,18325.89,26,2,6
2023-02-26 00:00:00,Other,3.42E+11,429.0,0.0,17896.89,26,2,6
2023-02-26 00:00:00,Misc,3.06E+11,2000.0,0.0,15896.89,26,2,6
2023-02-26 00:00:00,Misc,3.06E+11,302.0,0.0,15594.89,26,2,6
2023-02-27 00:00:00,Other,3.06E+11,299.0,0.0,15295.89,27,2,0
2023-02-27 00:00:00,Food,3.06E+11,20.0,0.0,15275.89,27,2,0
2023-02-27 00:00:00,Food,3.42E+11,40.0,0.0,15235.89,27,2,0
2023-02-27 00:00:00,Misc,3.06E+11,570.0,10000.0,14665.89,27,2,0
2023-02-27 00:00:00,Misc,3.06E+11,306.0,0.0,14359.89,27,2,0
2023-02-27 00:00:00,Food,3.06E+11,100.0,0.0,14259.89,27,2,0
2023-02-27 00:00:00,Misc,3.06E+11,1315.0,0.0,12944.89,27,2,0
2023-02-27 00:00:00,Food,3.42E+11,25.0,0.0,12919.89,27,2,0
2023-02-27 00:00:00,Food,3.42E+11,20.0,0.0,12899.89,27,2,0
2023-02-28 00:00:00,Food,3.06E+11,68.0,0.0,12831.89,28,2,1
2023-02-28 00:00:00,Food,3.43E+11,65.0,0.0,12766.89,28,2,1
2023-02-28 00:00:00,Food,3.43E+11,40.0,0.0,12726.89,28,2,1
2023-02-28 00:00:00,Misc,3.06E+11,830.0,0.0,11896.89,28,2,1
2023-03-13 00:00:00,Food,3.07E+11,20.0,0.0,286.26,13,3,0
2023-03-13 00:00:00,Food,3.07E+11,47.0,0.0,239.26,13,3,0
2023-03-13 00:00:00,Food,3.44E+11,65.0,0.0,174.26,13,3,0
2023-03-13 00:00:00,Food,3.07E+11,50.0,0.0,124.26,13,3,0
2023-03-13 00:00:00,Food,3.07E+11,85.0,0.0,39.26,13,3,0
2023-03-14 00:00:00,Misc,3.07E+11,0.0,1000.0,1039.26,14,3,1
2023-03-14 00:00:00,Food,3.44E+11,79.0,0.0,960.26,14,3,1
2023-03-14 00:00:00,Food,3.07E+11,30.0,0.0,930.26,14,3,1
2023-03-14 00:00:00,Food,3.07E+11,55.0,0.0,875.26,14,3,1
2023-03-15 00:00:00,Food,3.44E+11,33.0,0.0,842.26,15,3,2
2023-03-15 00:00:00,Food,3.44E+11,50.0,0.0,792.26,15,3,2
2023-03-15 00:00:00,Food,3.07E+11,55.0,0.0,737.26,15,3,2
2023-03-16 00:00:00,Misc,3.08E+11,136.0,0.0,601.26,16,3,3
2023-03-16 00:00:00,Food,3.44E+11,50.0,0.0,551.26,16,3,3
2023-03-16 00:00:00,Food,3.44E+11,35.0,0.0,516.26,16,3,3
2023-03-16 00:00:00,Food,3.08E+11,30.0,0.0,486.26,16,3,3
2023-03-16 00:00:00,Food,3.08E+11,65.0,0.0,421.26,16,3,3
2023-03-17 00:00:00,Food,3.08E+11,50.0,0.0,371.26,17,3,4
2023-03-17 00:00:00,Food,3.08E+11,30.0,0.0,341.26,17,3,4
2023-03-17 00:00:00,Food,3.08E+11,30.0,0.0,311.26,17,3,4
2023-03-17 00:00:00,Food,3.08E+11,75.0,0.0,236.26,17,3,4
2023-03-18 00:00:00,Food,3.44E+11,30.0,0.0,206.26,18,3,5
2023-03-18 00:00:00,Food,3.08E+11,35.0,0.0,171.26,18,3,5
2023-03-18 00:00:00,Food,3.08E+11,30.0,0.0,141.26,18,3,5
2023-03-19 00:00:00,Food,3.44E+11,61.0,0.0,80.26,19,3,6
2023-03-19 00:00:00,Food,3.08E+11,30.0,0.0,50.26,19,3,6
2023-03-19 00:00:00,Food,3.08E+11,10.0,0.0,40.26,19,3,6
2023-03-20 00:00:00,Food,3.08E+11,30.0,0.0,10.26,20,3,0
2023-03-21 00:00:00,Misc,3.08E+11,0.0,60.0,70.26,21,3,1
2023-03-21 00:00:00,Misc,3.45E+11,0.0,40.0,110.26,21,3,1
2023-03-22 00:00:00,Misc,3.45E+11,2.0,0.0,108.26,22,3,2
2023-03-22 00:00:00,Food,3.45E+11,42.0,0.0,66.26,22,3,2
2023-03-24 00:00:00,Other,CHAST23081324539,0.0,34800.0,34866.26,24,3,4
2023-03-24 00:00:00,Misc,3.45E+11,11000.0,0.0,23866.26,24,3,4
2023-03-24 00:00:00,Misc,3.45E+11,1926.72,0.0,21939.54,24,3,4
2023-03-24 00:00:00,Other,3.08E+11,670.0,0.0,21269.54,24,3,4
2023-03-24 00:00:00,Misc,3.45E+11,1479.0,0.0,19790.54,24,3,4
2023-03-24 00:00:00,Food,3.08E+11,81.0,0.0,19709.54,24,3,4
2023-03-24 00:00:00,Food,3.45E+11,48.0,0.0,19661.54,24,3,4
2023-03-24 00:00:00,Food,3.45E+11,72.0,0.0,19589.54,24,3,4
2023-03-24 00:00:00,Food,3.08E+11,42.0,0.0,19547.54,24,3,4
2023-03-24 00:00:00,Misc,3.08E+11,5000.0,0.0,14547.54,24,3,4
2023-03-24 00:00:00,Misc,3.08E+11,660.0,0.0,13887.54,24,3,4
2023-03-24 00:00:00,Food,3.45E+11,66.0,0.0,13821.54,24,3,4
2023-03-24 00:00:00,Food,3.45E+11,30.0,0.0,13791.54,24,3,4
2023-03-24 00:00:00,Food,3.45E+11,100.0,0.0,13691.54,24,3,4
2023-03-24 00:00:00,Misc,3.08E+11,1500.0,0.0,12191.54,24,3,4
2023-03-24 00:00:00,Food,3.08E+11,10.0,0.0,12181.54,24,3,4
2023-03-25 00:00:00,Food,3.08E+11,76.0,0.0,12105.54,25,3,5
2023-03-25 00:00:00,Food,3.45E+11,22.0,0.0,12083.54,25,3,5
2023-03-25 00:00:00,Food,3.45E+11,87.0,0.0,11996.54,25,3,5
2023-03-25 00:00:00,Misc,3.08E+11,470.0,0.0,11526.54,25,3,5
2023-03-25 00:00:00,Misc,3.08E+11,2826.0,0.0,8700.54,25,3,5
2023-03-26 00:00:00,Food,3.09E+11,32.0,0.0,8668.54,26,3,6
2023-03-26 00:00:00,Food,3.09E+11,72.0,0.0,8596.54,26,3,6
2023-03-26 00:00:00,Food,3.45E+11,10.0,0.0,8586.54,26,3,6
2023-03-26 00:00:00,Misc,3.45E+11,0.0,421.0,9007.54,26,3,6
2023-03-26 00:00:00,Misc,3.09E+11,150.0,0.0,8857.54,26,3,6
2023-03-26 00:00:00,Food,3.09E+11,80.0,0.0,8777.54,26,3,6
2023-03-26 00:00:00,Food,3.45E+11,41.0,0.0,8736.54,26,3,6
2023-03-26 00:00:00,Misc,3.45E+11,0.0,1000.0,9736.54,26,3,6
2023-03-26 00:00:00,Misc,3.09E+11,0.0,802.0,10538.54,26,3,6
2023-03-26 00:00:00,Misc,3.09E+11,0.0,927.0,11465.54,26,3,6
2023-03-26 00:00:00,Food,3.09E+11,10.0,0.0,11455.54,26,3,6
2023-03-27 00:00:00,Other,3.45E+11,254.0,0.0,11201.54,27,3,0
2023-03-27 00:00:00,Misc,3.45E+11,0.0,5130.0,16331.54,27,3,0
2023-03-27 00:00:00,Food,3.45E+11,40.0,0.0,16291.54,27,3,0
2023-03-28 00:00:00,Misc,3.45E+11,210.9,0.0,16080.64,28,3,1
2023-03-28 00:00:00,Misc,3.45E+11,144.0,0.0,15936.64,28,3,1
2023-03-28 00:00:00,Misc,3.09E+11,1000.0,0.0,14936.64,28,3,1
2023-03-28 00:00:00,Food,3.45E+11,52.0,0.0,14884.64,28,3,1
2023-03-28 00:00:00,Food,3.45E+11,30.0,0.0,14854.64,28,3,1
2023-03-28 00:00:00,Food,3.45E+11,42.0,0.0,14812.64,28,3,1
2023-03-29 00:00:00,Food,3.45E+11,22.0,0.0,14790.64,29,3,2
2023-03-29 00:00:00,Food,3.45E+11,32.0,0.0,14758.64,29,3,2
2023-03-29 00:00:00,Misc,3.45E+11,353.0,0.0,14405.64,29,3,2
2023-03-29 00:00:00,Food,3.45E+11,42.0,0.0,14363.64,29,3,2
2023-03-29 00:00:00,Food,3.09E+11,15.35,0.0,14348.29,29,3,2
2023-03-29 00:00:00,Misc,3.09E+11,220.0,0.0,14128.29,29,3,2
2023-03-29 00:00:00,Food,3.45E+11,20.0,0.0,14108.29,29,3,2
2023-03-30 00:00:00,Food,3.46E+11,90.0,0.0,14018.29,30,3,3
2023-03-30 00:00:00,Misc,3.46E+11,150.0,0.0,13868.29,30,3,3
2023-03-30 00:00:00,Food,3.46E+11,42.0,0.0,13826.29,30,3,3
2023-03-30 00:00:00,Food,3.46E+11,15.35,0.0,13810.94,30,3,3
2023-03-30 00:00:00,Misc,3.46E+11,354.0,0.0,13456.94,30,3,3
2023-03-30 00:00:00,Food,3.46E+11,55.0,0.0,13401.94,30,3,3
2023-03-30 00:00:00,Food,3.09E+11,75.0,0.0,13326.94,30,3,3
2023-03-30 00:00:00,Food,3.09E+11,50.0,0.0,13276.94,30,3,3
2023-03-31 00:00:00,Food,3.46E+11,47.0,0.0,13229.94,31,3,4
2023-03-31 00:00:00,Food,3.46E+11,40.0,0.0,13189.94,31,3,4
2023-03-31 00:00:00,Misc,3.46E+11,115.0,0.0,13074.94,31,3,4
2023-03-31 00:00:00,Food,3.46E+11,22.0,0.0,13052.94,31,3,4
2023-04-13 00:00:00,Food,3.47E+11,72.0,0.0,1887.51,13,4,3
2023-04-13 00:00:00,Food,3.10E+11,50.0,0.0,1837.51,13,4,3
2023-04-13 00:00:00,Food,3.10E+11,25.0,0.0,1812.51,13,4,3
2023-04-13 00:00:00,Food,3.10E+11,56.0,0.0,1756.51,13,4,3
2023-04-13 00:00:00,Food,3.47E+11,220.68,0.0,1535.83,13,4,3
2023-04-13 00:00:00,Food,3.47E+11,86.0,0.0,1449.83,13,4,3
2023-04-14 00:00:00,Food,3.47E+11,65.0,0.0,1384.83,14,4,4
2023-04-14 00:00:00,Food,3.10E+11,66.0,0.0,1318.83,14,4,4
2023-04-14 00:00:00,Food,3.47E+11,100.0,0.0,1218.83,14,4,4
2023-04-14 00:00:00,Misc,3.47E+11,160.0,0.0,1058.83,14,4,4
2023-04-14 00:00:00,Food,3.47E+11,70.0,0.0,988.83,14,4,4
2023-04-15 00:00:00,Food,3.11E+11,30.0,0.0,958.83,15,4,5
2023-04-15 00:00:00,Food,3.11E+11,100.0,0.0,858.83,15,4,5
2023-04-15 00:00:00,Food,3.47E+11,272.26,0.0,586.57,15,4,5
2023-04-15 00:00:00,Misc,3.47E+11,110.0,0.0,476.57,15,4,5
2023-04-15 00:00:00,Food,3.47E+11,75.0,0.0,401.57,15,4,5
2023-04-15 00:00:00,Food,3.47E+11,40.0,0.0,361.57,15,4,5
2023-04-16 00:00:00,Misc,3.11E+11,9.0,0.0,352.57,16,4,6
2023-04-16 00:00:00,Misc,3.47E+11,0.0,500.0,852.57,16,4,6
2023-04-16 00:00:00,Misc,3.47E+11,120.0,0.0,732.57,16,4,6
2023-04-16 00:00:00,Food,3.47E+11,50.0,0.0,682.57,16,4,6
2023-04-16 00:00:00,Other,3.47E+11,189.0,0.0,493.57,16,4,6
2023-04-16 00:00:00,Food,3.47E+11,30.0,0.0,463.57,16,4,6
2023-04-16 00:00:00,Food,3.47E+11,65.0,0.0,398.57,16,4,6
2023-04-16 00:00:00,Food,3.47E+11,10.0,0.0,388.57,16,4,6
2023-04-16 00:00:00,Food,3.11E+11,30.0,0.0,358.57,16,4,6
2023-04-16 00:00:00,Food,3.47E+11,80.0,0.0,278.57,16,4,6
2023-04-16 00:00:00,Food,3.47E+11,45.0,0.0,233.57,16,4,6
2023-04-17 00:00:00,Food,3.47E+11,65.0,0.0,168.57,17,4,0
2023-04-17 00:00:00,Food,3.11E+11,50.0,0.0,118.57,17,4,0
2023-04-17 00:00:00,Food,3.11E+11,15.3,0.0,103.27,17,4,0
2023-04-17 00:00:00,Food,3.47E+11,30.0,0.0,73.27,17,4,0
2023-04-18 00:00:00,Food,3.47E+11,20.0,0.0,53.27,18,4,1
2023-04-19 00:00:00,Food,3.11E+11,40.0,0.0,13.27,19,4,2
2023-04-19 00:00:00,Misc,3.48E+11,0.0,35.0,48.27,19,4,2
2023-04-20 00:00:00,Misc,3.11E+11,0.0,1180.0,1228.27,20,4,3
2023-04-20 00:00:00,Food,3.11E+11,41.0,0.0,1187.27,20,4,3
2023-04-20 00:00:00,Food,3.11E+11,20.0,0.0,1167.27,20,4,3
2023-04-20 00:00:00,Food,3.48E+11,41.0,0.0,1126.27,20,4,3
2023-04-20 00:00:00,Food,3.48E+11,90.0,0.0,1036.27,20,4,3
2023-04-20 00:00:00,Food,3.48E+11,75.0,0.0,961.27,20,4,3
2023-04-21 00:00:00,Food,3.11E+11,60.0,0.0,901.27,21,4,4
2023-04-21 00:00:00,Food,3.48E+11,90.0,0.0,811.27,21,4,4
2023-04-21 00:00:00,Misc,3.48E+11,130.0,0.0,681.27,21,4,4
2023-04-21 00:00:00,Food,3.48E+11,231.4,0.0,449.87,21,4,4
2023-04-22 00:00:00,Food,3.11E+11,40.0,0.0,409.87,22,4,5
2023-04-22 00:00:00,Misc,3.48E+11,120.0,0.0,289.87,22,4,5
2023-04-22 00:00:00,Food,3.48E+11,50.0,0.0,239.87,22,4,5
2023-04-22 00:00:00,Food,3.11E+11,25.0,0.0,214.87,22,4,5
2023-04-22 00:00:00,Food,3.11E+11,20.0,0.0,194.87,22,4,5
2023-04-22 00:00:00,Food,3.48E+11,50.0,0.0,144.87,22,4,5
2023-04-22 00:00:00,Food,3.48E+11,90.0,0.0,54.87,22,4,5
2023-04-22 00:00:00,Food,3.48E+11,35.0,0.0,19.87,22,4,5
2023-04-22 00:00:00,Food,3.48E+11,10.0,0.0,9.87,22,4,5
2023-04-23 00:00:00,Misc,3.11E+11,0.0,1745.0,1754.87,23,4,6
2023-04-23 00:00:00,Misc,3.48E+11,730.0,0.0,1024.87,23,4,6
2023-04-23 00:00:00,Food,3.48E+11,20.0,0.0,1004.87,23,4,6
2023-04-23 00:00:00,Food,3.48E+11,65.0,0.0,939.87,23,4,6
2023-04-24 00:00:00,Food,3.11E+11,40.0,0.0,899.87,24,4,0
2023-04-24 00:00:00,Food,3.11E+11,20.0,0.0,879.87,24,4,0
2023-04-24 00:00:00,Food,3.48E+11,20.0,0.0,859.87,24,4,0
2023-04-24 00:00:00,Food,3.48E+11,78.0,0.0,781.87,24,4,0
2023-04-24 00:00:00,Misc,3.11E+11,0.0,539.0,1320.87,24,4,0
2023-04-24 00:00:00,Food,3.48E+11,40.0,0.0,1280.87,24,4,0
2023-04-24 00:00:00,Food,3.48E+11,85.0,0.0,1195.87,24,4,0
2023-04-24 00:00:00,Food,3.11E+11,15.3,0.0,1180.57,24,4,0
2023-04-24 00:00:00,Food,3.48E+11,30.0,0.0,1150.57,24,4,0
2023-04-24 00:00:00,Food,3.48E+11,342.4,0.0,808.17,24,4,0
2023-04-24 00:00:00,Food,3.48E+11,0.0,292.4,1100.57,24,4,0
2023-04-24 00:00:00,Food,3.48E+11,205.45,0.0,895.12,24,4,0
2023-04-25 00:00:00,Food,3.12E+11,29.3,0.0,865.82,25,4,1
2023-04-25 00:00:00,Other,CHAST23111858452,0.0,34800.0,35665.82,25,4,1
2023-04-25 00:00:00,Misc,3.12E+11,10000.0,0.0,25665.82,25,4,1
2023-04-25 00:00:00,Misc,3.12E+11,999.0,0.0,24666.82,25,4,1
2023-04-25 00:00:00,Misc,3.48E+11,110.0,0.0,24556.82,25,4,1
2023-04-25 00:00:00,Food,3.48E+11,50.0,0.0,24506.82,25,4,1
2023-04-25 00:00:00,Misc,3.12E+11,1.0,0.0,24505.82,25,4,1
2023-04-25 00:00:00,Misc,3.12E+11,4999.0,0.0,19506.82,25,4,1
2023-04-25 00:00:00,Misc,3.48E+11,275.0,0.0,19231.82,25,4,1
2023-04-25 00:00:00,Misc,3.12E+11,0.0,141.0,19372.82,25,4,1
2023-04-25 00:00:00,Food,3.48E+11,92.0,0.0,19280.82,25,4,1
2023-04-25 00:00:00,Food,3.48E+11,28.0,0.0,19252.82,25,4,1
2023-04-26 00:00:00,Other,3.12E+11,399.0,0.0,18853.82,26,4,2
2023-04-26 00:00:00,Food,3.48E+11,95.0,0.0,18758.82,26,4,2
2023-04-26 00:00:00,Other,3.48E+11,539.0,0.0,18219.82,26,4,2
2023-04-26 00:00:00,Food,3.12E+11,85.0,0.0,18134.82,26,4,2
2023-04-26 00:00:00,Misc,3.48E+11,0.0,1000.0,19134.82,26,4,2
2023-04-26 00:00:00,Misc,3.48E+11,120.0,0.0,19014.82,26,4,2
2023-04-26 00:00:00,Food,3.48E+11,30.0,0.0,18984.82,26,4,2
2023-04-27 00:00:00,Food,3.12E+11,30.0,0.0,18954.82,27,4,3
2023-04-27 00:00:00,Other,3.12E+11,400.0,0.0,18554.82,27,4,3
2023-04-27 00:00:00,Misc,3.12E+11,190.0,0.0,18364.82,27,4,3
2023-04-27 00:00:00,Other,3.12E+11,0.0,400.0,18764.82,27,4,3
2023-04-27 00:00:00,Misc,3.12E+11,2023.0,0.0,16741.82,27,4,3
2023-04-27 00:00:00,Food,3.12E+11,15.0,0.0,16726.82,27,4,3
2023-04-27 00:00:00,Food,3.12E+11,287.95,0.0,16438.87,27,4,3
2023-04-27 00:00:00,Other,3.48E+11,700.0,0.0,15738.87,27,4,3
2023-04-27 00:00:00,Food,3.48E+11,20.0,0.0,15718.87,27,4,3
2023-04-27 00:00:00,Food,3.12E+11,100.0,0.0,15618.87,27,4,3
2023-04-27 00:00:00,Food,3.48E+11,100.0,0.0,15518.87,27,4,3
2023-04-27 00:00:00,Food,3.48E+11,28.0,0.0,15490.87,27,4,3
2023-04-28 00:00:00,Food,3.12E+11,10.0,0.0,15480.87,28,4,4
2023-04-28 00:00:00,Food,3.12E+11,70.0,0.0,15410.87,28,4,4
2023-04-28 00:00:00,Food,3.12E+11,10.0,0.0,15400.87,28,4,4
2023-04-28 00:00:00,Misc,3.48E+11,180.0,0.0,15220.87,28,4,4
2023-04-28 00:00:00,Misc,3.48E+11,0.0,120.0,15340.87,28,4,4
2023-04-28 00:00:00,Food,3.48E+11,30.0,0.0,15310.87,28,4,4
2023-04-28 00:00:00,Food,3.48E+11,75.0,0.0,15235.87,28,4,4
2023-04-28 00:00:00,Food,3.48E+11,42.0,0.0,15193.87,28,4,4
2023-04-28 00:00:00,Misc,3.48E+11,180.0,0.0,15013.87,28,4,4
2023-04-28 00:00:00,Misc,3.12E+11,0.0,90.0,15103.87,28,4,4
2023-04-28 00:00:00,Food,3.48E+11,35.0,0.0,15068.87,28,4,4
2023-04-28 00:00:00,Food,3.48E+11,30.0,0.0,15038.87,28,4,4
2023-04-29 00:00:00,Misc,3.49E+11,220.0,0.0,14818.87,29,4,5
2023-04-29 00:00:00,Food,3.49E+11,40.0,0.0,14778.87,29,4,5
2023-04-29 00:00:00,Food,3.12E+11,75.0,0.0,14703.87,29,4,5
2023-04-29 00:00:00,Misc,3.49E+11,280.0,0.0,14423.87,29,4,5
2023-04-29 00:00:00,Misc,3.49E+11,120.0,0.0,14303.87,29,4,5
2023-04-29 00:00:00,Food,3.49E+11,60.0,0.0,14243.87,29,4,5
2023-04-29 00:00:00,Food,3.49E+11,40.0,0.0,14203.87,29,4,5
2023-04-30 00:00:00,Food,3.12E+11,64.0,0.0,14139.87,30,4,6
2023-04-30 00:00:00,Food,3.12E+11,80.0,0.0,14059.87,30,4,6
2023-04-30 00:00:00,Other,3.49E+11,1044.0,0.0,13015.87,30,4,6
2023-04-30 00:00:00,Food,3.49E+11,300.35,0.0,12715.52,30,4,6
2023-04-30 00:00:00,Food,3.49E+11,85.0,0.0,12630.52,30,4,6
2023-04-30 00:00:00,Misc,3.49E+11,152.0,0.0,12478.52,30,4,6
2023-04-30 00:00:00,Food,3.49E+11,50.0,0.0,12428.52,30,4,6
2023-05-13 00:00:00,Misc,3.13E+11,0.0,130.0,1072.36,13,5,5
2023-05-13 00:00:00,Misc,3.50E+11,125.0,0.0,947.36,13,5,5
2023-05-13 00:00:00,Food,3.50E+11,40.0,0.0,907.36,13,5,5
2023-05-13 00:00:00,Misc,3.50E+11,120.0,0.0,787.36,13,5,5
2023-05-14 00:00:00,Misc,3.50E+11,121.0,0.0,666.36,14,5,6
2023-05-14 00:00:00,Food,3.13E+11,40.0,0.0,626.36,14,5,6
2023-05-14 00:00:00,Food,3.50E+11,60.0,0.0,566.36,14,5,6
2023-05-14 00:00:00,Misc,3.13E+11,154.5,0.0,411.86,14,5,6
2023-05-14 00:00:00,Food,3.13E+11,45.0,0.0,366.86,14,5,6
2023-05-14 00:00:00,Food,3.50E+11,75.0,0.0,291.86,14,5,6
2023-05-14 00:00:00,Misc,3.13E+11,0.0,60.0,351.86,14,5,6
2023-05-14 00:00:00,Misc,3.13E+11,0.0,120.0,471.86,14,5,6
2023-05-15 00:00:00,Misc,3.14E+11,0.0,500.0,971.86,15,5,0
2023-05-15 00:00:00,Food,3.50E+11,65.0,0.0,906.86,15,5,0
2023-05-15 00:00:00,Food,3.50E+11,50.0,0.0,856.86,15,5,0
2023-05-15 00:00:00,Food,3.50E+11,65.0,0.0,791.86,15,5,0
2023-05-16 00:00:00,Food,3.14E+11,54.0,0.0,737.86,16,5,1
2023-05-16 00:00:00,Misc,3.50E+11,140.0,0.0,597.86,16,5,1
2023-05-16 00:00:00,Food,3.50E+11,60.0,0.0,537.86,16,5,1
2023-05-16 00:00:00,Food,3.50E+11,30.0,0.0,507.86,16,5,1
2023-05-16 00:00:00,Food,3.14E+11,20.0,0.0,487.86,16,5,1
2023-05-16 00:00:00,Misc,3.50E+11,101.0,0.0,386.86,16,5,1
2023-05-17 00:00:00,Food,3.50E+11,75.0,0.0,311.86,17,5,2
2023-05-17 00:00:00,Food,3.14E+11,60.0,0.0,251.86,17,5,2
2023-05-17 00:00:00,Food,3.50E+11,54.0,0.0,197.86,17,5,2
2023-05-17 00:00:00,Misc,3.50E+11,150.0,0.0,47.86,17,5,2
2023-05-17 00:00:00,Food,3.50E+11,40.0,0.0,7.86,17,5,2
2023-05-18 00:00:00,Misc,3.50E+11,0.0,170.0,177.86,18,5,3
2023-05-18 00:00:00,Food,3.50E+11,80.0,0.0,97.86,18,5,3
2023-05-18 00:00:00,Misc,3.50E+11,0.0,1000.0,1097.86,18,5,3
2023-05-18 00:00:00,Food,3.50E+11,55.0,0.0,1042.86,18,5,3
2023-05-18 00:00:00,Food,3.50E+11,44.0,0.0,998.86,18,5,3
2023-05-19 00:00:00,Food,3.14E+11,50.0,0.0,948.86,19,5,4
2023-05-19 00:00:00,Misc,3.51E+11,140.0,0.0,808.86,19,5,4
2023-05-19 00:00:00,Food,3.14E+11,30.0,0.0,778.86,19,5,4
2023-05-19 00:00:00,Food,3.51E+11,76.0,0.0,702.86,19,5,4
2023-05-20 00:00:00,Misc,3.51E+11,500.0,0.0,202.86,20,5,5
2023-05-20 00:00:00,Food,3.51E+11,33.0,0.0,169.86,20,5,5
2023-05-20 00:00:00,Food,3.14E+11,58.0,0.0,111.86,20,5,5
2023-05-20 00:00:00,Food,3.14E+11,95.0,0.0,16.86,20,5,5
2023-05-21 00:00:00,Misc,3.51E+11,0.0,110.0,126.86,21,5,6
2023-05-22 00:00:00,Food,3.51E+11,10.0,0.0,116.86,22,5,0
2023-05-23 00:00:00,Food,3.51E+11,72.0,0.0,44.86,23,5,1
2023-05-23 00:00:00,Misc,3.14E+11,0.0,300.0,344.86,23,5,1
2023-05-23 00:00:00,Food,3.14E+11,90.0,0.0,254.86,23,5,1
2023-05-23 00:00:00,Food,3.51E+11,30.0,0.0,224.86,23,5,1
2023-05-24 00:00:00,Food,3.51E+11,30.0,0.0,194.86,24,5,2
2023-05-25 00:00:00,Other,CHASU23143454301,0.0,34800.0,34994.86,25,5,3
2023-05-25 00:00:00,Misc,3.15E+11,1000.0,0.0,33994.86,25,5,3
2023-05-25 00:00:00,Misc,3.15E+11,10000.0,0.0,23994.86,25,5,3
2023-05-25 00:00:00,Misc,3.51E+11,270.0,0.0,23724.86,25,5,3
2023-05-25 00:00:00,Food,3.51E+11,40.0,0.0,23684.86,25,5,3
2023-05-25 00:00:00,Food,3.51E+11,72.0,0.0,23612.86,25,5,3
2023-05-25 00:00:00,Food,3.51E+11,20.0,0.0,23592.86,25,5,3
2023-05-25 00:00:00,Food,3.51E+11,363.9,0.0,23228.96,25,5,3
2023-05-25 00:00:00,Misc,3.51E+11,10000.0,0.0,13228.96,25,5,3
2023-05-25 00:00:00,Food,3.51E+11,40.0,0.0,13188.96,25,5,3
2023-05-26 00:00:00,Misc,3.15E+11,0.0,10.0,13198.96,26,5,4
2023-05-26 00:00:00,Misc,3.15E+11,239.0,0.0,12959.96,26,5,4
2023-05-26 00:00:00,Food,3.51E+11,65.0,0.0,12894.96,26,5,4
2023-05-26 00:00:00,Food,3.15E+11,50.0,0.0,12844.96,26,5,4
2023-05-26 00:00:00,Misc,3.51E+11,2185.0,0.0,10659.96,26,5,4
2023-05-26 00:00:00,Misc,3.51E+11,200.0,0.0,10459.96,26,5,4
2023-05-26 00:00:00,Misc,3.51E+11,115.0,0.0,10344.96,26,5,4
2023-05-26 00:00:00,Misc,3.51E+11,204.0,0.0,10140.96,26,5,4
2023-05-27 00:00:00,Food,3.15E+11,10.0,0.0,10130.96,27,5,5
2023-05-27 00:00:00,Food,3.15E+11,10.0,0.0,10120.96,27,5,5
2023-05-27 00:00:00,Misc,3.51E+11,307.0,0.0,9813.96,27,5,5
2023-05-27 00:00:00,Misc,3.51E+11,0.0,675.0,10488.96,27,5,5
2023-05-27 00:00:00,Misc,3.51E+11,1500.0,0.0,8988.96,27,5,5
2023-05-27 00:00:00,Misc,3.51E+11,180.0,0.0,8808.96,27,5,5
2023-05-27 00:00:00,Food,3.51E+11,20.0,0.0,8788.96,27,5,5
2023-05-27 00:00:00,Misc,3.15E+11,0.0,675.0,9463.96,27,5,5
2023-05-28 00:00:00,Other,3.51E+11,197.0,0.0,9266.96,28,5,6
2023-05-28 00:00:00,Food,3.51E+11,80.0,0.0,9186.96,28,5,6
2023-05-28 00:00:00,Food,3.51E+11,100.0,0.0,9086.96,28,5,6
2023-05-28 00:00:00,Food,3.51E+11,55.0,0.0,9031.96,28,5,6
2023-05-28 00:00:00,Misc,3.15E+11,364.0,0.0,8667.96,28,5,6
2023-05-28 00:00:00,Other,3.15E+11,186.0,0.0,8481.96,28,5,6
2023-05-28 00:00:00,Food,3.51E+11,30.0,0.0,8451.96,28,5,6
2023-06-13 00:00:00,Food,3.53E+11,55.0,0.0,3013.55,13,6,1
2023-06-13 00:00:00,Food,3.53E+11,30.0,0.0,2983.55,13,6,1
2023-06-13 00:00:00,Food,3.53E+11,50.0,0.0,2933.55,13,6,1
2023-06-13 00:00:00,Food,3.53E+11,100.0,0.0,2833.55,13,6,1
2023-06-13 00:00:00,Food,3.16E+11,20.0,0.0,2813.55,13,6,1
2023-06-13 00:00:00,Food,3.16E+11,30.0,0.0,2783.55,13,6,1
2023-06-13 00:00:00,Misc,3.53E+11,0.0,1000.0,3783.55,13,6,1
2023-06-13 00:00:00,Food,3.53E+11,28.0,0.0,3755.55,13,6,1
2023-06-14 00:00:00,Food,3.17E+11,40.0,0.0,3715.55,14,6,2
2023-06-14 00:00:00,Misc,3.53E+11,1100.0,0.0,2615.55,14,6,2
2023-06-14 00:00:00,Misc,3.17E+11,125.0,0.0,2490.55,14,6,2
2023-06-14 00:00:00,Food,3.17E+11,100.0,0.0,2390.55,14,6,2
2023-06-14 00:00:00,Misc,3.53E+11,385.0,0.0,2005.55,14,6,2
2023-06-14 00:00:00,Misc,3.17E+11,750.0,0.0,1255.55,14,6,2
2023-06-15 00:00:00,Food,3.17E+11,10.0,0.0,1245.55,15,6,3
2023-06-15 00:00:00,Misc,3.17E+11,138.0,0.0,1107.55,15,6,3
2023-06-15 00:00:00,Food,3.17E+11,10.0,0.0,1097.55,15,6,3
2023-06-16 00:00:00,Food,3.17E+11,100.0,0.0,997.55,16,6,4
2023-06-16 00:00:00,Food,3.17E+11,60.0,0.0,937.55,16,6,4
2023-06-16 00:00:00,Food,3.53E+11,100.0,0.0,837.55,16,6,4
2023-06-17 00:00:00,Food,3.53E+11,60.0,0.0,777.55,17,6,5
2023-06-17 00:00:00,Food,3.53E+11,10.0,0.0,767.55,17,6,5
2023-06-18 00:00:00,Food,3.17E+11,20.0,0.0,747.55,18,6,6
2023-06-18 00:00:00,Food,3.17E+11,10.0,0.0,737.55,18,6,6
2023-06-18 00:00:00,Food,3.54E+11,20.0,0.0,717.55,18,6,6
2023-06-18 00:00:00,Food,3.54E+11,40.0,0.0,677.55,18,6,6
2023-06-18 00:00:00,Food,3.54E+11,50.0,0.0,627.55,18,6,6
2023-06-19 00:00:00,Food,3.54E+11,20.0,0.0,607.55,19,6,0
2023-06-19 00:00:00,Misc,3.17E+11,0.0,400.0,1007.55,19,6,0
2023-06-19 00:00:00,Misc,3.54E+11,327.0,0.0,680.55,19,6,0
2023-06-20 00:00:00,Food,3.54E+11,25.0,0.0,655.55,20,6,1
2023-06-21 00:00:00,Food,3.54E+11,20.0,0.0,635.55,21,6,2
2023-06-21 00:00:00,Food,3.54E+11,55.0,0.0,580.55,21,6,2
2023-06-21 00:00:00,Food,3.54E+11,40.0,0.0,540.55,21,6,2
2023-06-21 00:00:00,Food,3.54E+11,10.0,0.0,530.55,21,6,2
2023-06-21 00:00:00,Food,3.54E+11,20.0,0.0,510.55,21,6,2
2023-06-21 00:00:00,Misc,3.17E+11,8.26,0.0,502.29,21,6,2
2023-06-23 00:00:00,Other,CHASU23172917734,0.0,34800.0,35302.29,23,6,4
2023-06-23 00:00:00,Misc,3.17E+11,2000.0,0.0,33302.29,23,6,4
2023-06-23 00:00:00,Misc,3.54E+11,3000.0,0.0,30302.29,23,6,4
2023-06-24 00:00:00,Misc,3.18E+11,10000.0,0.0,20302.29,24,6,5
2023-06-24 00:00:00,Misc,3.18E+11,1000.0,0.0,19302.29,24,6,5
2023-06-24 00:00:00,Food,3.18E+11,100.0,0.0,19202.29,24,6,5
2023-06-24 00:00:00,Misc,3.18E+11,409.0,0.0,18793.29,24,6,5
2023-06-24 00:00:00,Misc,3.18E+11,200.0,0.0,18593.29,24,6,5
2023-06-24 00:00:00,Misc,3.18E+11,424.0,0.0,18169.29,24,6,5
2023-06-25 00:00:00,Misc,3.54E+11,600.0,0.0,17569.29,25,6,6
2023-06-25 00:00:00,Food,3.54E+11,100.0,0.0,17469.29,25,6,6
2023-06-26 00:00:00,Misc,3.54E+11,5000.0,0.0,12469.29,26,6,0
2023-06-26 00:00:00,Misc,3.18E+11,528.44,0.0,11940.85,26,6,0
2023-06-26 00:00:00,Misc,3.18E+11,0.0,1.0,11941.85,26,6,0
2023-06-27 00:00:00,Food,3.54E+11,100.0,0.0,11841.85,27,6,1
2023-06-27 00:00:00,Misc,3.18E+11,2100.0,0.0,9741.85,27,6,1
2023-06-27 00:00:00,Misc,3.54E+11,119.0,0.0,9622.85,27,6,1
2023-06-28 00:00:00,Misc,3.18E+11,500.0,0.0,9122.85,28,6,2
2023-06-28 00:00:00,Misc,3.55E+11,7630.0,0.0,1492.85,28,6,2
2023-06-30 00:00:00,Misc,3.55E+11,467.0,0.0,1025.85,30,6,4
2023-07-13 00:00:00,Food,3.19E+11,60.0,0.0,1338.94,13,7,3
2023-07-13 00:00:00,Food,3.56E+11,198.32,0.0,1140.62,13,7,3
2023-07-13 00:00:00,Food,3.19E+11,50.0,0.0,1090.62,13,7,3
2023-07-13 00:00:00,Food,3.19E+11,50.0,0.0,1040.62,13,7,3
2023-07-13 00:00:00,Food,3.19E+11,20.0,0.0,1020.62,13,7,3
2023-07-13 00:00:00,Food,3.19E+11,10.0,0.0,1010.62,13,7,3
2023-07-14 00:00:00,Misc,3.20E+11,5.0,0.0,1005.62,14,7,4
2023-07-14 00:00:00,Misc,3.20E+11,270.0,0.0,735.62,14,7,4
2023-07-14 00:00:00,Food,3.20E+11,70.0,0.0,665.62,14,7,4
2023-07-14 00:00:00,Food,3.20E+11,10.0,0.0,655.62,14,7,4
2023-07-14 00:00:00,Food,3.20E+11,40.0,0.0,615.62,14,7,4
2023-07-14 00:00:00,Food,3.20E+11,71.0,0.0,544.62,14,7,4
2023-07-15 00:00:00,Food,3.20E+11,40.0,0.0,504.62,15,7,5
2023-07-15 00:00:00,Food,3.20E+11,40.0,0.0,464.62,15,7,5
2023-07-15 00:00:00,Misc,3.20E+11,345.0,0.0,119.62,15,7,5
2023-07-16 00:00:00,Food,3.20E+11,20.0,0.0,99.62,16,7,6
2023-07-16 00:00:00,Food,3.20E+11,40.0,0.0,59.62,16,7,6
2023-07-16 00:00:00,Food,3.20E+11,20.0,0.0,39.62,16,7,6
2023-07-17 00:00:00,Food,3.20E+11,30.0,0.0,9.62,17,7,0
2023-07-19 00:00:00,Misc,3.57E+11,0.0,1000.0,1009.62,19,7,2
2023-07-20 00:00:00,Food,3.20E+11,100.0,0.0,909.62,20,7,3
2023-07-20 00:00:00,Food,3.20E+11,30.0,0.0,879.62,20,7,3
2023-07-20 00:00:00,Food,3.20E+11,70.0,0.0,809.62,20,7,3
2023-07-20 00:00:00,Food,3.20E+11,50.0,0.0,759.62,20,7,3
2023-07-20 00:00:00,Food,3.20E+11,40.0,0.0,719.62,20,7,3
2023-07-20 00:00:00,Misc,3.20E+11,207.0,0.0,512.62,20,7,3
2023-07-21 00:00:00,Food,3.20E+11,92.0,0.0,420.62,21,7,4
2023-07-21 00:00:00,Misc,3.20E+11,250.0,0.0,170.62,21,7,4
2023-07-21 00:00:00,Misc,3.20E+11,0.0,1000.0,1170.62,21,7,4
2023-07-21 00:00:00,Food,3.20E+11,58.0,0.0,1112.62,21,7,4
2023-07-21 00:00:00,Misc,3.20E+11,220.0,0.0,892.62,21,7,4
2023-07-21 00:00:00,Food,3.20E+11,50.0,0.0,842.62,21,7,4
2023-07-22 00:00:00,Food,3.20E+11,100.0,0.0,742.62,22,7,5
2023-07-22 00:00:00,Food,3.20E+11,41.0,0.0,701.62,22,7,5
2023-07-22 00:00:00,Food,3.20E+11,41.0,0.0,660.62,22,7,5
2023-07-22 00:00:00,Food,3.20E+11,50.0,0.0,610.62,22,7,5
2023-07-22 00:00:00,Food,3.20E+11,90.0,0.0,520.62,22,7,5
2023-07-22 00:00:00,Food,3.20E+11,40.0,0.0,480.62,22,7,5
2023-07-22 00:00:00,Food,3.20E+11,10.0,0.0,470.62,22,7,5
2023-07-22 00:00:00,Food,3.20E+11,30.0,0.0,440.62,22,7,5
2023-07-23 00:00:00,Misc,3.57E+11,0.0,500.0,940.62,23,7,6
2023-07-23 00:00:00,Food,3.20E+11,10.0,0.0,930.62,23,7,6
2023-07-23 00:00:00,Misc,3.20E+11,160.0,0.0,770.62,23,7,6
2023-07-23 00:00:00,Food,3.20E+11,30.0,0.0,740.62,23,7,6
2023-07-23 00:00:00,Food,3.20E+11,30.0,0.0,710.62,23,7,6
2023-07-23 00:00:00,Misc,3.20E+11,180.0,0.0,530.62,23,7,6
2023-07-23 00:00:00,Food,3.20E+11,51.0,0.0,479.62,23,7,6
2023-07-23 00:00:00,Food,3.20E+11,10.0,0.0,469.62,23,7,6
2023-07-24 00:00:00,Food,3.21E+11,20.0,0.0,449.62,24,7,0
2023-07-24 00:00:00,Food,3.21E+11,20.0,0.0,429.62,24,7,0
2023-07-24 00:00:00,Misc,3.21E+11,170.0,0.0,259.62,24,7,0
2023-07-24 00:00:00,Food,3.21E+11,50.0,0.0,209.62,24,7,0
2023-07-24 00:00:00,Food,3.21E+11,50.0,0.0,159.62,24,7,0
2023-07-25 00:00:00,Other,CHASV23202393703,0.0,34800.0,34959.62,25,7,1
2023-07-25 00:00:00,Other,3.21E+11,2553.0,0.0,32406.62,25,7,1
2023-07-25 00:00:00,Misc,3.21E+11,10000.0,0.0,22406.62,25,7,1
2023-07-25 00:00:00,Food,3.57E+11,50.0,0.0,22356.62,25,7,1
2023-07-25 00:00:00,Misc,3.21E+11,1001.0,0.0,21355.62,25,7,1
2023-07-25 00:00:00,Misc,3.21E+11,130.0,0.0,21225.62,25,7,1
2023-07-25 00:00:00,Food,3.21E+11,60.0,0.0,21165.62,25,7,1
2023-07-25 00:00:00,Misc,3.21E+11,7500.0,0.0,13665.62,25,7,1
2023-07-25 00:00:00,Food,3.21E+11,70.0,0.0,13595.62,25,7,1
2023-07-25 00:00:00,Misc,3.21E+11,350.0,0.0,13245.62,25,7,1
2023-07-25 00:00:00,Food,3.21E+11,30.0,0.0,13215.62,25,7,1
2023-07-25 00:00:00,Other,3.57E+11,259.0,0.0,12956.62,25,7,1
2023-07-26 00:00:00,Other,3.21E+11,0.0,259.0,13215.62,26,7,2
2023-07-26 00:00:00,Other,3.21E+11,249.0,0.0,12966.62,26,7,2
2023-07-26 00:00:00,Misc,3.21E+11,1000.0,0.0,11966.62,26,7,2
2023-07-26 00:00:00,Food,3.21E+11,40.0,0.0,11926.62,26,7,2
2023-07-26 00:00:00,Misc,3.21E+11,1500.0,0.0,10426.62,26,7,2
2023-07-26 00:00:00,Misc,3.21E+11,150.0,0.0,10276.62,26,7,2
2023-07-26 00:00:00,Food,3.21E+11,60.0,0.0,10216.62,26,7,2
2023-07-26 00:00:00,Misc,3.21E+11,480.0,0.0,9736.62,26,7,2
2023-07-26 00:00:00,Food,3.21E+11,40.0,0.0,9696.62,26,7,2
2023-07-26 00:00:00,Misc,3.21E+11,200.0,0.0,9496.62,26,7,2
2023-07-27 00:00:00,Misc,3.21E+11,108.0,0.0,9388.62,27,7,3
2023-07-27 00:00:00,Food,3.21E+11,100.0,0.0,9288.62,27,7,3
2023-07-27 00:00:00,Misc,3.21E+11,175.0,0.0,9113.62,27,7,3
2023-07-27 00:00:00,Misc,3.21E+11,150.0,0.0,8963.62,27,7,3
2023-07-27 00:00:00,Food,3.21E+11,20.0,0.0,8943.62,27,7,3
2023-07-27 00:00:00,Food,3.21E+11,30.0,0.0,8913.62,27,7,3
2023-07-27 00:00:00,Misc,3.21E+11,5.0,0.0,8908.62,27,7,3
2023-07-27 00:00:00,Other,3.57E+11,199.0,0.0,8709.62,27,7,3
2023-07-27 00:00:00,Food,3.21E+11,75.0,0.0,8634.62,27,7,3
2023-07-27 00:00:00,Food,3.21E+11,20.0,0.0,8614.62,27,7,3
2023-07-28 00:00:00,Food,3.58E+11,30.0,0.0,8584.62,28,7,4
2023-07-28 00:00:00,Food,3.21E+11,23.0,0.0,8561.62,28,7,4
2023-07-28 00:00:00,Food,3.21E+11,10.0,0.0,8551.62,28,7,4
2023-07-28 00:00:00,Food,3.21E+11,60.0,0.0,8491.62,28,7,4
2023-07-29 00:00:00,Food,3.21E+11,50.0,0.0,8441.62,29,7,5
2023-07-29 00:00:00,Food,3.21E+11,40.0,0.0,8401.62,29,7,5
2023-07-29 00:00:00,Misc,3.21E+11,160.0,0.0,8241.62,29,7,5
2023-07-29 00:00:00,Misc,3.21E+11,320.0,0.0,7921.62,29,7,5
2023-07-30 00:00:00,Food,3.21E+11,50.0,0.0,7871.62,30,7,6
2023-07-30 00:00:00,Misc,3.21E+11,170.0,0.0,7701.62,30,7,6
2023-07-30 00:00:00,Food,3.21E+11,20.0,0.0,7681.62,30,7,6
2023-07-30 00:00:00,Food,3.21E+11,30.0,0.0,7651.62,30,7,6
2023-07-30 00:00:00,Food,3.21E+11,20.0,0.0,7631.62,30,7,6
2023-07-31 00:00:00,Misc,3.21E+11,110.0,0.0,7521.62,31,7,0
2023-08-13 00:00:00,Misc,3.23E+11,0.0,2000.0,2141.62,13,8,6
2023-08-13 00:00:00,Food,3.23E+11,80.0,0.0,2061.62,13,8,6
2023-08-13 00:00:00,Food,3.23E+11,50.0,0.0,2011.62,13,8,6
2023-08-13 00:00:00,Misc,3.23E+11,130.0,0.0,1881.62,13,8,6
2023-08-13 00:00:00,Misc,3.23E+11,189.0,0.0,1692.62,13,8,6
2023-08-13 00:00:00,Food,3.23E+11,30.0,0.0,1662.62,13,8,6
2023-08-13 00:00:00,Misc,3.23E+11,500.0,0.0,1162.62,13,8,6
2023-08-13 00:00:00,Food,3.23E+11,10.0,0.0,1152.62,13,8,6
2023-08-14 00:00:00,Food,3.23E+11,99.0,0.0,1053.62,14,8,0
2023-08-14 00:00:00,Food,3.23E+11,50.0,0.0,1003.62,14,8,0
2023-08-14 00:00:00,Food,3.23E+11,50.0,0.0,953.62,14,8,0
2023-08-14 00:00:00,Misc,3.23E+11,358.0,0.0,595.62,14,8,0
2023-08-14 00:00:00,Food,3.23E+11,30.0,0.0,565.62,14,8,0
2023-08-15 00:00:00,Food,3.23E+11,20.0,0.0,545.62,15,8,1
2023-08-15 00:00:00,Food,3.23E+11,40.0,0.0,505.62,15,8,1
2023-08-15 00:00:00,Food,3.23E+11,30.0,0.0,475.62,15,8,1
2023-08-15 00:00:00,Misc,3.23E+11,0.0,25.0,500.62,15,8,1
2023-08-16 00:00:00,Food,3.23E+11,60.0,0.0,440.62,16,8,2
2023-08-16 00:00:00,Food,3.23E+11,10.0,0.0,430.62,16,8,2
2023-08-16 00:00:00,Food,3.23E+11,40.0,0.0,390.62,16,8,2
2023-08-16 00:00:00,Food,3.23E+11,42.0,0.0,348.62,16,8,2
2023-08-16 00:00:00,Misc,3.23E+11,230.0,0.0,118.62,16,8,2
2023-08-16 00:00:00,Food,3.23E+11,40.0,0.0,78.62,16,8,2
2023-08-17 00:00:00,Food,3.23E+11,50.0,0.0,28.62,17,8,3
2023-08-17 00:00:00,Misc,3.23E+11,0.0,1500.0,1528.62,17,8,3
2023-08-17 00:00:00,Misc,3.23E+11,1000.0,0.0,528.62,17,8,3
2023-08-17 00:00:00,Food,3.23E+11,50.0,0.0,478.62,17,8,3
2023-08-17 00:00:00,Food,3.60E+11,161.55,0.0,317.07,17,8,3
2023-08-18 00:00:00,Food,3.23E+11,60.0,0.0,257.07,18,8,4
2023-08-18 00:00:00,Food,3.23E+11,40.0,0.0,217.07,18,8,4
2023-08-18 00:00:00,Food,3.60E+11,67.2,0.0,149.87,18,8,4
2023-08-18 00:00:00,Food,3.23E+11,20.0,0.0,129.87,18,8,4
2023-08-18 00:00:00,Misc,3.23E+11,0.0,1000.0,1129.87,18,8,4
2023-08-18 00:00:00,Food,3.23E+11,86.0,0.0,1043.87,18,8,4
2023-08-18 00:00:00,Misc,3.60E+11,276.0,0.0,767.87,18,8,4
2023-08-18 00:00:00,Food,3.23E+11,50.0,0.0,717.87,18,8,4
2023-08-19 00:00:00,Misc,3.23E+11,390.0,0.0,327.87,19,8,5
2023-08-19 00:00:00,Food,3.23E+11,40.0,0.0,287.87,19,8,5
2023-08-19 00:00:00,Misc,3.23E+11,0.0,1000.0,1287.87,19,8,5
2023-08-19 00:00:00,Food,3.23E+11,50.0,0.0,1237.87,19,8,5
2023-08-19 00:00:00,Food,3.23E+11,40.0,0.0,1197.87,19,8,5
2023-08-20 00:00:00,Food,3.23E+11,20.0,0.0,1177.87,20,8,6
2023-08-20 00:00:00,Food,3.23E+11,30.0,0.0,1147.87,20,8,6
2023-08-20 00:00:00,Food,3.23E+11,60.0,0.0,1087.87,20,8,6
2023-08-20 00:00:00,Food,3.23E+11,60.0,0.0,1027.87,20,8,6
2023-08-20 00:00:00,Misc,3.23E+11,5.0,0.0,1022.87,20,8,6
2023-08-20 00:00:00,Food,3.60E+11,174.95,0.0,847.92,20,8,6
2023-08-20 00:00:00,Food,3.23E+11,40.0,0.0,807.92,20,8,6
2023-08-20 00:00:00,Misc,3.23E+11,400.0,0.0,407.92,20,8,6
2023-08-20 00:00:00,Food,3.23E+11,20.0,0.0,387.92,20,8,6
2023-08-21 00:00:00,Misc,3.23E+11,160.0,0.0,227.92,21,8,0
2023-08-21 00:00:00,Food,3.23E+11,50.0,0.0,177.92,21,8,0
2023-08-21 00:00:00,Food,3.23E+11,22.0,0.0,155.92,21,8,0
2023-08-21 00:00:00,Food,3.60E+11,75.0,0.0,80.92,21,8,0
2023-08-21 00:00:00,Food,3.23E+11,40.0,0.0,40.92,21,8,0
2023-08-22 00:00:00,Misc,3.23E+11,0.0,1000.0,1040.92,22,8,1
2023-08-22 00:00:00,Food,3.60E+11,70.0,0.0,970.92,22,8,1
2023-08-22 00:00:00,Misc,3.23E+11,0.0,70.0,1040.92,22,8,1
2023-08-22 00:00:00,Food,3.60E+11,55.0,0.0,985.92,22,8,1
2023-08-22 00:00:00,Food,3.23E+11,50.0,0.0,935.92,22,8,1
2023-08-22 00:00:00,Food,3.23E+11,10.0,0.0,925.92,22,8,1
2023-08-22 00:00:00,Food,3.23E+11,38.0,0.0,887.92,22,8,1
2023-08-22 00:00:00,Food,3.23E+11,20.0,0.0,867.92,22,8,1
2023-08-23 00:00:00,Food,3.60E+11,28.0,0.0,839.92,23,8,2
2023-08-23 00:00:00,Food,3.24E+11,23.0,0.0,816.92,23,8,2
2023-08-23 00:00:00,Food,3.24E+11,30.0,0.0,786.92,23,8,2
2023-08-23 00:00:00,Food,3.24E+11,50.0,0.0,736.92,23,8,2
2023-08-23 00:00:00,Food,3.24E+11,30.0,0.0,706.92,23,8,2
2023-08-23 00:00:00,Misc,3.24E+11,200.0,0.0,506.92,23,8,2
2023-08-24 00:00:00,Food,3.24E+11,201.0,0.0,305.92,24,8,3
2023-08-24 00:00:00,Food,3.24E+11,100.0,0.0,205.92,24,8,3
2023-08-24 00:00:00,Food,3.24E+11,50.0,0.0,155.92,24,8,3
2023-08-24 00:00:00,Food,3.24E+11,59.0,0.0,96.92,24,8,3
2023-08-24 00:00:00,Food,3.24E+11,50.0,0.0,46.92,24,8,3
2023-08-25 00:00:00,Other,CHASV23235906561,0.0,34800.0,34846.92,25,8,4
2023-08-25 00:00:00,Misc,3.60E+11,5000.0,0.0,29846.92,25,8,4
2023-08-25 00:00:00,Misc,3.60E+11,8000.0,0.0,21846.92,25,8,4
2023-08-25 00:00:00,Misc,3.60E+11,1000.0,0.0,20846.92,25,8,4
2023-08-25 00:00:00,Misc,3.60E+11,1000.0,0.0,19846.92,25,8,4
2023-08-25 00:00:00,Food,3.24E+11,34.0,0.0,19812.92,25,8,4
2023-08-25 00:00:00,Misc,3.24E+11,1000.0,0.0,18812.92,25,8,4
2023-08-25 00:00:00,Misc,3.24E+11,380.0,0.0,18432.92,25,8,4
2023-08-25 00:00:00,Misc,3.60E+11,0.0,140.0,18572.92,25,8,4
2023-08-25 00:00:00,Food,3.24E+11,100.0,0.0,18472.92,25,8,4
2023-08-25 00:00:00,Misc,3.24E+11,1720.0,0.0,16752.92,25,8,4
2023-08-25 00:00:00,Misc,3.24E+11,200.0,0.0,16552.92,25,8,4
2023-08-25 00:00:00,Misc,3.24E+11,188.0,0.0,16364.92,25,8,4
2023-08-25 00:00:00,Food,3.24E+11,40.0,0.0,16324.92,25,8,4
2023-08-25 00:00:00,Food,3.24E+11,70.0,0.0,16254.92,25,8,4
2023-08-25 00:00:00,Misc,3.60E+11,0.0,15.0,16269.92,25,8,4
2023-08-25 00:00:00,Food,3.24E+11,50.0,0.0,16219.92,25,8,4
2023-08-26 00:00:00,Misc,3.24E+11,120.0,0.0,16099.92,26,8,5
2023-08-26 00:00:00,Food,3.24E+11,30.0,0.0,16069.92,26,8,5
2023-08-26 00:00:00,Misc,3.24E+11,430.0,0.0,15639.92,26,8,5
2023-08-26 00:00:00,Misc,3.60E+11,0.0,70.0,15709.92,26,8,5
2023-08-26 00:00:00,Misc,3.24E+11,112.0,0.0,15597.92,26,8,5
2023-08-26 00:00:00,Misc,3.60E+11,0.0,10.0,15607.92,26,8,5
2023-08-26 00:00:00,Misc,3.24E+11,118.0,0.0,15489.92,26,8,5
2023-08-26 00:00:00,Food,3.24E+11,10.0,0.0,15479.92,26,8,5
2023-08-26 00:00:00,Misc,3.24E+11,1000.0,0.0,14479.92,26,8,5
2023-08-26 00:00:00,Food,3.60E+11,188.2,0.0,14291.72,26,8,5
2023-08-26 00:00:00,Food,3.60E+11,40.0,0.0,14251.72,26,8,5
2023-08-27 00:00:00,Misc,3.24E+11,199.0,0.0,14052.72,27,8,6
2023-08-27 00:00:00,Food,3.24E+11,30.0,0.0,14022.72,27,8,6
2023-08-27 00:00:00,Food,3.24E+11,58.0,0.0,13964.72,27,8,6
2023-08-27 00:00:00,Misc,3.61E+11,0.0,12.0,13976.72,27,8,6
2023-08-27 00:00:00,Food,3.24E+11,100.0,0.0,13876.72,27,8,6
2023-08-27 00:00:00,Food,3.24E+11,50.0,0.0,13826.72,27,8,6
2023-08-28 00:00:00,Food,3.24E+11,203.66,0.0,13623.06,28,8,0
2023-08-28 00:00:00,Misc,3.61E+11,105.0,0.0,13518.06,28,8,0
2023-08-28 00:00:00,Food,3.24E+11,40.0,0.0,13478.06,28,8,0
2023-08-29 00:00:00,Misc,3.24E+11,5.0,0.0,13473.06,29,8,1
2023-08-29 00:00:00,Food,3.61E+11,23.0,0.0,13450.06,29,8,1
2023-08-29 00:00:00,Food,3.24E+11,30.0,0.0,13420.06,29,8,1
2023-08-29 00:00:00,Food,3.24E+11,43.0,0.0,13377.06,29,8,1
2023-08-29 00:00:00,Food,3.24E+11,10.0,0.0,13367.06,29,8,1
2023-08-29 00:00:00,Food,3.61E+11,185.2,0.0,13181.86,29,8,1
2023-08-30 00:00:00,Misc,3.61E+11,110.0,0.0,13071.86,30,8,2
2023-08-30 00:00:00,Misc,3.24E+11,0.0,55.0,13126.86,30,8,2
2023-08-30 00:00:00,Food,3.24E+11,40.0,0.0,13086.86,30,8,2
2023-08-30 00:00:00,Food,3.61E+11,100.0,0.0,12986.86,30,8,2
2023-08-30 00:00:00,Food,3.24E+11,40.0,0.0,12946.86,30,8,2
2023-08-31 00:00:00,Food,3.24E+11,30.0,0.0,12916.86,31,8,3
2023-08-31 00:00:00,Food,3.61E+11,100.0,0.0,12816.86,31,8,3
2023-08-31 00:00:00,Food,3.24E+11,30.0,0.0,12786.86,31,8,3
2023-08-31 00:00:00,Misc,3.24E+11,0.0,20000.0,32786.86,31,8,3
2023-08-31 00:00:00,Misc,3.24E+11,20000.0,0.0,12786.86,31,8,3
2023-08-31 00:00:00,Misc,3.24E+11,440.0,0.0,12346.86,31,8,3
2023-09-13 00:00:00,Food,3.62E+11,23.0,0.0,22.33,13,9,2
2023-09-16 00:00:00,Food,3.26E+11,10.0,0.0,12.33,16,9,5
2023-09-23 00:00:00,Misc,3.27E+11,0.0,1000.0,1012.33,23,9,5
2023-09-23 00:00:00,Misc,3.27E+11,300.1,0.0,712.23,23,9,5
2023-09-23 00:00:00,Misc,3.27E+11,700.0,0.0,12.23,23,9,5
2023-09-25 00:00:00,Other,CHASH26441571950,0.0,34800.0,34812.23,25,9,0
2023-09-25 00:00:00,Misc,3.27E+11,7451.0,0.0,27361.23,25,9,0
2023-09-25 00:00:00,Misc,3.63E+11,0.0,7152.0,34513.23,25,9,0
2023-09-25 00:00:00,Misc,3.27E+11,8624.0,0.0,25889.23,25,9,0
2023-09-25 00:00:00,Misc,3.63E+11,10000.0,0.0,15889.23,25,9,0
2023-09-25 00:00:00,Misc,3.63E+11,2313.0,0.0,13576.23,25,9,0
2023-09-25 00:00:00,Misc,3.63E+11,7500.0,0.0,6076.23,25,9,0
2023-09-25 00:00:00,Misc,3.27E+11,120.0,0.0,5956.23,25,9,0
2023-09-25 00:00:00,Food,3.27E+11,36.0,0.0,5920.23,25,9,0
2023-09-25 00:00:00,Food,3.27E+11,40.0,0.0,5880.23,25,9,0
2023-09-25 00:00:00,Misc,3.63E+11,275.0,0.0,5605.23,25,9,0
2023-09-25 00:00:00,Misc,3.27E+11,329.0,0.0,5276.23,25,9,0
2023-09-26 00:00:00,Food,3.27E+11,36.0,0.0,5240.23,26,9,1
2023-09-26 00:00:00,Food,3.27E+11,10.0,0.0,5230.23,26,9,1
2023-09-26 00:00:00,Food,3.27E+11,50.0,0.0,5180.23,26,9,1
2023-09-26 00:00:00,Food,3.64E+11,159.56,0.0,5020.67,26,9,1
2023-09-26 00:00:00,Misc,3.27E+11,1000.0,0.0,4020.67,26,9,1
2023-09-27 00:00:00,Food,3.64E+11,55.0,0.0,3965.67,27,9,2
2023-09-27 00:00:00,Food,3.27E+11,50.0,0.0,3915.67,27,9,2
2023-09-28 00:00:00,Food,3.64E+11,100.0,0.0,3815.67,28,9,3
2023-09-28 00:00:00,Food,3.27E+11,40.0,0.0,3775.67,28,9,3
2023-09-28 00:00:00,Food,3.64E+11,155.5,0.0,3620.17,28,9,3
2023-09-28 00:00:00,Misc,3.27E+11,240.0,0.0,3380.17,28,9,3
2023-09-28 00:00:00,Misc,3.27E+11,247.0,0.0,3133.17,28,9,3
2023-09-29 00:00:00,Food,3.27E+11,48.0,0.0,3085.17,29,9,4
2023-09-29 00:00:00,Food,3.27E+11,20.0,0.0,3065.17,29,9,4
2023-09-29 00:00:00,Misc,3.27E+11,880.0,0.0,2185.17,29,9,4
2023-09-30 00:00:00,Misc,3.27E+11,110.0,0.0,2075.17,30,9,5
2023-09-30 00:00:00,Food,3.27E+11,10.0,0.0,2065.17,30,9,5
2023-09-30 00:00:00,Misc,3.27E+11,183.85,0.0,1881.32,30,9,5
2023-09-30 00:00:00,Food,3.27E+11,50.0,0.0,1831.32,30,9,5
2023-10-13 00:00:00,Food,3.29E+11,36.0,0.0,721.89,13,10,4
2023-10-13 00:00:00,Misc,3.65E+11,270.0,0.0,451.89,13,10,4
2023-10-14 00:00:00,Food,3.29E+11,24.0,0.0,427.89,14,10,5
2023-10-14 00:00:00,Misc,3.29E+11,0.0,270.0,697.89,14,10,5
2023-10-16 00:00:00,Misc,3.29E+11,291.0,0.0,406.89,16,10,0
2023-10-16 00:00:00,Misc,3.66E+11,0.0,3500.0,3906.89,16,10,0
2023-10-16 00:00:00,Misc,3.29E+11,1500.0,0.0,2406.89,16,10,0
2023-10-16 00:00:00,Misc,3.29E+11,0.0,286.0,2692.89,16,10,0
2023-10-16 00:00:00,Misc,3.29E+11,300.0,0.0,2392.89,16,10,0
2023-10-16 00:00:00,Misc,3.29E+11,150.0,0.0,2242.89,16,10,0
2023-10-16 00:00:00,Food,3.29E+11,40.0,0.0,2202.89,16,10,0
2023-10-16 00:00:00,Misc,3.66E+11,248.0,0.0,1954.89,16,10,0
2023-10-16 00:00:00,Food,3.66E+11,30.0,0.0,1924.89,16,10,0
2023-10-16 00:00:00,Food,3.66E+11,214.74,0.0,1710.15,16,10,0
2023-10-17 00:00:00,Food,3.29E+11,65.0,0.0,1645.15,17,10,1
2023-10-17 00:00:00,Misc,3.29E+11,706.0,0.0,939.15,17,10,1
2023-10-17 00:00:00,Misc,3.29E+11,150.0,0.0,789.15,17,10,1
2023-10-17 00:00:00,Misc,3.29E+11,234.0,0.0,555.15,17,10,1
2023-10-17 00:00:00,Food,3.29E+11,60.0,0.0,495.15,17,10,1
2023-10-18 00:00:00,Food,3.29E+11,65.0,0.0,430.15,18,10,2
2023-10-18 00:00:00,Food,3.29E+11,10.0,0.0,420.15,18,10,2
2023-10-19 00:00:00,Food,3.29E+11,20.0,0.0,400.15,19,10,3
2023-10-20 00:00:00,Food,3.29E+11,18.0,0.0,382.15,20,10,4
2023-10-20 00:00:00,Food,3.29E+11,25.0,0.0,357.15,20,10,4
2023-10-26 00:00:00,Food,3.30E+11,100.0,0.0,257.15,26,10,3
2023-10-26 00:00:00,Misc,3.30E+11,0.0,3150.0,3407.15,26,10,3
2023-10-27 00:00:00,Misc,3.67E+11,3407.0,0.0,0.15,27,10,4
2023-11-15 00:00:00,Misc,CHASH31948851670,0.0,33209.0,33209.15,15,11,2
2023-11-15 00:00:00,Misc,3.69E+11,5000.0,0.0,28209.15,15,11,2
2023-11-15 00:00:00,Misc,3.69E+11,3500.0,0.0,24709.15,15,11,2
2023-11-15 00:00:00,Misc,3.69E+11,20000.0,0.0,4709.15,15,11,2
2023-11-15 00:00:00,Misc,3.69E+11,1500.0,0.0,3209.15,15,11,2
2023-11-17 00:00:00,Food,3.32E+11,69.0,0.0,3140.15,17,11,4
2023-11-18 00:00:00,Food,3.32E+11,100.0,0.0,3040.15,18,11,5
2023-11-18 00:00:00,Misc,3.32E+11,116.0,0.0,2924.15,18,11,5
2023-11-20 00:00:00,Other,3.69E+11,1999.0,0.0,925.15,20,11,0
2023-11-20 00:00:00,Other,3.69E+11,0.0,1999.0,2924.15,20,11,0
2023-11-22 00:00:00,Misc,3.33E+11,150.0,0.0,2774.15,22,11,2
2023-11-22 00:00:00,Misc,3.33E+11,150.0,0.0,2624.15,22,11,2
2023-11-24 00:00:00,Other,CHASH32649207986,0.0,24769.0,27393.15,24,11,4
2023-11-24 00:00:00,Other,3.69E+11,499.0,0.0,26894.15,24,11,4
2023-11-24 00:00:00,Misc,3.33E+11,1499.0,0.0,25395.15,24,11,4
2023-11-24 00:00:00,Misc,3.69E+11,2000.0,0.0,23395.15,24,11,4
2023-11-25 00:00:00,Misc,3.70E+11,21000.0,0.0,2395.15,25,11,5
2023-11-26 00:00:00,Food,3.33E+11,223.18,0.0,2171.97,26,11,6
2023-11-27 00:00:00,Misc,3.33E+11,0.0,272.0,2443.97,27,11,0
2023-11-27 00:00:00,Misc,3.70E+11,720.0,0.0,1723.97,27,11,0
2023-11-28 00:00:00,Misc,3.70E+11,480.0,0.0,1243.97,28,11,1
2023-11-28 00:00:00,Misc,3.70E+11,250.0,0.0,993.97,28,11,1
2023-11-30 00:00:00,Misc,3.70E+11,130.0,0.0,863.97,30,11,3
2023-11-30 00:00:00,Misc,3.33E+11,0.0,50.0,913.97,30,11,3
2023-12-13 00:00:00,Food,3.71E+11,26.0,0.0,46.68,13,12,2
2023-12-13 00:00:00,Food,3.71E+11,15.0,0.0,31.68,13,12,2
2023-12-13 00:00:00,Transport,3.35E+11,0.0,1718.0,1749.68,13,12,2
2023-12-13 00:00:00,Misc,3.71E+11,1718.0,0.0,31.68,13,12,2
06/04/25,Clothes,,476.72,0.0,3608.98,6,4,6
06/04/25,Clothes,,418.24,0.0,1665.13,6,4,6
06/04/25,Clothes,,200.84,0.0,2992.17,6,4,6
06/04/25,Clothes,,492.23,0.0,4480.37,6,4,6
06/04/25,Clothes,,115.67,0.0,3437.53,6,4,6
06/04/25,Clothes,,463.59,0.0,3034.17,6,4,6
06/04/25,Clothes,,251.15,0.0,4522.1,6,4,6
06/04/25,Clothes,,461.91,0.0,3062.04,6,4,6
06/04/25,Clothes,,403.27,0.0,4515.7,6,4,6
06/04/25,Clothes,,222.19,0.0,4442.61,6,4,6
06/04/25,Clothes,,178.96,0.0,2994.54,6,4,6
06/04/25,Clothes,,477.7,0.0,2609.36,6,4,6
06/04/25,Clothes,,166.94,0.0,3748.45,6,4,6
06/04/25,Clothes,,144.23,0.0,2828.34,6,4,6
06/04/25,Clothes,,130.86,0.0,1372.75,6,4,6
2025-04-06 01:54:35.675795,Clothes,,-0.3830453715434543,0.7902489121756849,-1.1824958272254784,6,4,6
2025-04-06 01:54:35.678824,Clothes,,-0.019502659151358227,-0.3259663532631326,0.1258711241656904,6,4,6
2025-04-06 01:54:35.680824,Clothes,,0.8154963784211658,0.43679095316466193,-0.7497079908557243,6,4,6
2025-04-06 01:54:51.761997,Clothes,,0.07823280107092319,0.19527360944848696,0.2700432450114255,6,4,6
2025-04-06 01:54:51.766001,Clothes,,-0.918519502630422,0.18289779065482192,0.2907253276235538,6,4,6
2025-04-06 01:54:51.769004,Clothes,,0.02301499514500435,-0.8508023798149851,1.1556442064494497,6,4,6
